トキオ =To kyo
キンペ =Lha sa
ウール =Shan ghai
シンガ =Ma cau
モンゴー=Asta na
ハバロフ=Har bin
スクワモ=Mos cow
ライク =Ka bul
シバーリ=Irk utsk
サラム =Am man
ホルトー=Sevi lla
マーロ =Rome
オフラン=Pa ris
アテーネ=Vien na
ウイン =Pra gue
ゲルマン=Riga
バリテン=Lon don
ストック=Tal linn
ラスカー=Ju neau
シアトー=Seat tle
ヨーク =New York
ゴシカ =Dal las
ヒュース=Hous ton
ペガス =Port land
アステカ=Ana heim
パマナ =Bo gota
バランシ=Cara cas
サンバ =Rio
コルバト=La Paz
ナスカ =Lima
リッチ =Sant iago
パラス =Bras ilia
チュール=Akur eyri
ゴット =Nuuk
キビック=Dub lin
ビースン=Oslo
ザイルー=Lome
イジップ=Cai ro
ロッコ =Ra bat
ケーニア=Nai robi
タッカル=Ba mako
ケープ =Pret oria
シドーニ=Sid ney
ホルン =Adel aide
パース =Per th
ターウイ=Ali ce
フリッツ=Cai rns
リンン =Auck land
リントン=Lyn ton