トキオ =Tokyo
キンペ =Lhasa
ウール =Shanghai
シンガ =Macau
モンゴー=Astana
ハバロフ=Harbin
スクワモ=Moscow
ライク =Kabul
シバーリ=Irkutsk
サラム =Amman
ホルトー=Sevilla
マーロ =Rome
オフラン=Paris
アテーネ=Vienna
ウイン =Prague
ゲルマン=Riga
バリテン=London
ストック=Tallinn
ラスカー=Juneau
シアトー=Seattle
ヨーク =New York
ゴシカ =Dallas
ヒュース=Houston
ペガス =Portland
アステカ=Anaheim
パマナ =Bogota
バランシ=Caracas
サンバ =Rio
コルバト=La Paz
ナスカ =Lima
リッチ =Santiago
パラス =Brasilia
チュール=Akureyri
ゴット =Nuuk
キビック=Dublin
ビースン=Oslo
ザイルー=Lome
イジップ=Cairo
ロッコ =Rabat
ケーニア=Nairobi
タッカル=Bamako
ケープ =Pretoria
シドーニ=Sidney
ホルン =Adelaide
パース =Perth
ターウイ=Alice
フリッツ=Cairns
リンン =Auckland
リントン=Auckland