な\u0020\u0020し    =None
ナイフ    =Knife
ダガー    =Dagger
グラディウス =Gladius
ハンドアクス =Axe
レイピア   =Rapier
スピア    =Spear
せスタス   =Cestus
メイス    =Mace
フレイル   =Flail
サーベル   =Saber
トライデント =Trident
バトルフィスト=Claw
シミター   =Pulwar
ロングソード =Long Sword
バトルアクス =Battle Axe
ロングスピア =Ranseur
せルフボウ  =Fire bow
クロスボウ  =Cross bow
ウォーハンマー=Hammer
エストック  =Estoc
ロングボウ  =Long bow
リピーター  =Rifle
ヌンチャク  =Karate sticks
シャムシール =Talwar
グレートアクス=Great Axe
モール    =Great Mace
グレートソード=Great Sword
アーバレスト =Arblast
パルチザン  =Spetum
ハルベルト  =Halberd
エルブンボウ =Elven Bow
きこうけん  =Qigong Fist
フレイムソード=Fire Sword
らんぶのつるぎ=Dancing Blade
サンダーアクス=Thunder Axe
シルバーソード=Silver Sword
たいまのやり =Holy Spear
スリープアロー=Sleep Arrow
げんむのつえ =Dream Staff
ポイズンブロウ=Poison Dart
ソウルイーター=Soul Eater
オーラナックル=Divine Fist
ごうりゅうけん=Union sword
あんこくけん =Draco Blade
